7 7 12 3 3
 X X . . .M.S.
 XB. - + . . .
 . .B.N. . - +
 . .N.N.N. +B.
N. . EN.B. . .
 . .B.B. + . X
 2 . 1 . .B. X