8 7 8 9 8 10
N.N. . + . .S.
B3 . .M. .B. .
 .B. | .N. . .
 . . . 1 |B. .
M.B. + . . . .
 EM. .M. . .N.
 .M. .N.M. .N.
N.N. . . 2 .N.