8 10 10 11 18
 . . . | .N. . . . .
 . 2 . . | . . . . .
 . . .N.N. .N. . . .
M. .M. . .M. .N. | .
 .M. .M.M. 1N. . . |
M. .M. .M. .N.M. . .
 . .S. . .N.N. EM. +
 X X X X X X X XB. -