8 10 15 12 11
 . .N. . . | .M. .B.
 . .B. . . + . .M. E
 . .N. | . |B.N. . .
 1 . . . .N. +N. . |
N.N. . . .N. -N. . .
N. . .N.N.N. 2N. | .
N.M.M.B.M.N. .B. . .
 .M. .S.M.N. . . . .