11 5 50
 .M.S.M. .
N.B.N.M.N.
 .M. . | .
 . . . . .
 . . . . .
 . . . . .
 . . . . .
 . . . . .
 . . . . .
 . . . . .
 . . . . .