8 10 15 11 11
 . .N. . . | .M. . .
 . .B. . . + . .M. E
 . .N. . . | .N. . .
 1 . . . .N. -N. . |
N.N. . . .N. +N. . .
N. . .N.N.N. 2N. | .
N.M.M.B.M.N. .B. . .
 .M. .S.M.N. . . . .