10 5 13 11 6 3
 XN. . . .
 X EM. . .
 XM.B. _ 2
 X . . . .
 X .N. . |
 X . .N. 3
 X . + . |
 1M.M.M.M.
 X | . . .
 X . . .S.