8 16 0
 . . . . . . . . . . . . . . . .
 . . . . . . . .N. . . . . . . .
 . . . . . . . . . . . . . . . .
 . . . . . . . . . . . . . . . .
 . . . . . . . . . . . . . . . .
 . . . . . . . . . . . . . . . .
 X X X X X X X X . X X X X X X X
 X X X X X X X X . X X X X X X X