7 13 0
 X X X X X X X X X X X X X
 . . . . . . . . . . . . .
 . . . . . . . . . . . . .
 . . . . . . . . . . . . .
 . . . . . . . . . . . . .
 . . . . . .S. . . . . . .
 . . . . . . . . . . . . .