8 14 0
 X X X X X X X X X X X X X X
 X X X X X X X X X X X X X X
 . . . . . . . . . . . . . .
 . . . . . . . . . . . . . .
 . . . . . . . . . . . . . .
 . . . . . . . . . . . . . .
 . . . . . . .S.B. . . . . .
 . . . . . . . . . . . . . .